███                 █████████
█   ███████████████████   █ █
█ ████                █ █ █ █
█ ███████████████████ █ █ █ █
█                     █ █ █ █
█████████████████████ █ █ █ █
█   ██                █ █ █ █
█ █ ██ ███ ██ █████████ █ █ █
█ █    █   ██B█         █ █ █
█ █ ██ ████████████████ █ █ █
███ ██             ████ █ █ █
███ ██████████████ ██ █ █ █ █
███             ██    █ █ █ █
██████ ████████ ███████ █ █ █
██████ ████             █   █
A      ██████████████████████
